Richard	NICE
Jennifer	NICE
Elizabeth	NAUGHTY
Lisa	NICE
Charles	NICE
Steven	NICE
Margaret	NICE
William	NAUGHTY
Linda	NICE
Barbara	NICE
Betty	NICE
Paul	NICE
Robert	NICE
John	NAUGHTY
Sarah	NICE
Mark	NAUGHTY
Emily	NAUGHTY
Michael	NICE
Mary	NAUGHTY
Kimberly	NAUGHTY
Michelle	NICE
Matthew	NAUGHTY
Joshua	NICE
Patricia	NAUGHTY
Thomas	NAUGHTY
Donna	NAUGHTY
Susan	NICE
Sandra	NICE
Donald	NICE
Nancy	NAUGHTY
David	NICE
Anthony	NAUGHTY
Jessica	NICE
Christopher	NAUGHTY
Karen	NAUGHTY
Ashley	NAUGHTY
Daniel	NAUGHTY
James	NAUGHTY
Joseph	NAUGHTY
Andrew	NICE
